WWWWWWWWWWWWWWWWWWWWWWWWWWWWWWWWWWWWWWWWWWWWWWWWWW
WBBBBBBBBBBBBBBBBBBBBBBBBBBBBBBBBBBBBBBBBBBBBBBBBW
WBBBBBBBBBBBBBBBBBBBBBBBBBBBBBBBBBBBBBBBBBBBBBBBBW
WBBBBBBBBBBBBBBBBBBBBBBBBBBBBBBBBMBBBBBBBBBBBBBBBW
WBBBBBBBMBBBBBBBBBBBBBBBBBBBBBBBBBBBBBBBBBBBBBBBBW
WBBBBBBBBBBBBBBBBBBBBBBBBBBBBBBBBBBBBBBBBBBBBBBBBW
WBBBBBBBBBBBBBBBBBBBBBBBBBBBBBBBBBBBBBBBBBBBBBBBBW
WBBBBBBBBBBBBBBBBBBBBBBBBBBBBBBBBBBBBBBBBBBBBBBBBW
WBBBBBBBBBBBBBBBBBBBBBBBBBBBBBBBBBBBBBBBBBBBBBBBBW
WBBBBBBBBBBBBBBBBBBBBBBBBBBBBBBBBBBBBBBBBBBBBBBBBW
WBBBBBBBBBBBBBBBBBBBBBMBBBBBBBBBBBBBBBBBBBBBBBBBBW
WBBBBBBBBBBBBBBBBBBBBBBBBBBBBBBBBBBBBBBBBBBBBBBBBW
WBBBBBBBBBBBBBBBBBBBBBBBBBBBBBBBBBBBBBBBBBBBBBBBBW
WBBBBBBBBBBBBBBBBBBBBBBBBBBBBBBBBBBBBBBBBBBBBBBBBW
WBBBBBBBBBBBMBBBBBBBBBBBBBBBBBBBBBBBBBMBBBBBBBBBBW
WBBBBBBBBBBBBBBBBBBBBBBBBBBBBBBBBBBBBBBBBBBBBBBBBW
WBBBBBBBBBBBBBBBBBBBBBBBBBBBBBBBBBBBBBBBBBBBBBBBBW
WBBBBBBBBBBBBBBBBBBBBBBBBBBBBBBBBBBBBBBBBBBBBBBBBW
WBBBBBBBBBBBBBBBBBBBBBBBBBBBBBBBBBBBBBBBBBBBBBBBBW
WBBBBBBBBBBBBBBBBBBBBBBMBBBBBBBBBBBBBBBBBBBBBBBBBW
WBBBBBBBBBBBBBBBBBBBBBBBBBBBBBBBBBBBBBBBBBBBBBBBBW
WBBBBBBBBBMBBBBBBBBBBBBBBBBBBBBBBBBBBBBBBBBBBBBBBW
WBBBBBBBBBBBBBBBBBBBBBBBBBBBBBBBBBBBBBBBBBBBBBBBBW
WBBBBBBBBBBBBBBBBBBBBBBBBBBBBBBBBMBBBBBBBBBBBBBBBW
WBBBBBBBBBBBBBBBBBBBBBBBBBBBBBBBBBBBBBBBBBBBBBBBBW
WBBBBBBBBBBBBBBBBBBBBBBMBMBBBBBBBBBBBBBBBBBBBBBBBW
WBBBBBBBBBBBBBBBBBBBBBBBBBBBBBBBBBBBBBBBBBBBBBBBBW
WBBBBBBBBBBBBBBBBBBBBBBBBBBBBBBBBBBBBBBBBBBBBBBBBW
WBBBBBBBBBBBBBBBBBBBBBBBBBBBBBBBBBBBBBBBBBBBBBBBBW
WWWWWWWWWWWWWWWWWWWWWWWWWWWWWWWWWWWWWWWWWWWWWWWWWW