WWWWWWWWWWWWWWWWWWWWWWWWWWWWWWWWWWWWWWWWWWWWWWWWWW
WBBBBBBBMBBBBDBBBBBBBBBBBBWWBBBBBBBBBBBBBBBBBBBBBW
WBBBBBBBBBBBBDBBBBBBBBBBBBWWWWWWBBBBBBBBBBBDBBBBBW
WBBBBBBBBBBBBBBBBBBBBBBBBBBBBBBWBMBBBBBBBBMWBBBBBW
WWWWWWWWWWWBBBBBBBBBBBBBBBBBBBBWBBBBBBBBBBBBBBBBBW
WBBBBBBBBBBBBBBBBBBBBBBBBBBBBBBPBBBBBBBBBBBBBBBBBW
WBBBBBBBBBBBBBBBBBBBBBBBBBBBBBBBBBBBBBBBBBBBBPBBBW
WBBBBBBBBBWWWWWBBBBBBBBBBBBBBBBBBBBBBBBBBBBBBBBBBW
WBBBBBWWWWWBBBBBBBBBBBBBBBBBBBBBBBBBBBDBBBBBBBBBBW
WBBBBBBBBBPBBBBBBBBBBBBBBBBBBBBBBBBBBBBBBBBBBBBBBW
WBBBBBBBBBWWBBBBBBBBBBMBBBBBBBBBBBBBBBBBBBBBBBBBBW
WBBBBBBBBBBBBBBBBDBBBBBBBBBBBBBBBBBBBBBBBBBWWWWWWW
WWWWWWWWWBBBBBBBBBBBBBBBBBBBBBBBBBBBBBBBBBBBBBBBBW
WBBBDBBBWBBBBBBBBBBBBBBBBBBBBBBBBBBBBBBBBBBBBBBBBW
WBBBBBBBWBBBMBBBBBBBBPWWWWBBBBBBBBBBBBMBBBBBBBBBBW
WBBBBBBBBBBBBBBBBBBBBBWBBBBBBBBBBBWWBBBMBBBBBBBBBW
WBBBBBBBBBBBBBBBBBBBBBWBBBBBBBBBBBBBBBBBBBBBBBBBBW
WBBBBBBBBBBBBBBBBBBBBBWBBBBBBBBBBBBBBBBBBBBBBBBBBW
WBBBBBBBBBBBBBBBBBBBWWWBBBBBBBBBBBBBBBMBBBBBBBBBBW
WBBBBBBBBBBBBBBBBBBBBBBMBBBBBBBBBBBBBBBBBBBBBBBBBW
WWWWWPWWWPWWBBBBBBBBBBBBBBBBBBBBBBBBBBBBBBBBBBBBBW
WBBBBBBBBBMBBBBBBBBBBBBBBBBBBBBBBBBBBBBBBBBBBBBBBW
WBBBBBMBBBBBBBBBBBBBBBBBBBBBBBBBBBBBBBBBBBBBBBBBBW
WBBBBBBBBBBBBBBBBBBWWWWWWWWWPBBBBMBBBBBBBBBBBBBBBW
WPBBBBBBBBBBBBBBBBBBDBBBBWWWWWWWWBBBBBBBBBBBBBBBBW
WBBBBBWWWWBBBBBBBBBBBBBMBWBBBBBBWBBBBBBBBBBBBBBBBW
WBBBBBBWBBBBBBBBBBBBBBBBBWBBBBBBPBBBBBBBBBBBBBBBBW
WBBBBBBWBBBBBBBBBBBBBBBBBWWWWWPWWBBBBBBBBBBBBBBBBW
WBBBBBBWBBBBBBBBBBBBBBBBBBBBBBBBBBBBBBBBBBBBBBBBBW
WWWWWWWWWWWWWWWWWWWWWWWWWWWWWWWWWWWWWWWWWWWWWWWWWW