WWWWWWWWWWWWWWWWWWWWWWWWWWWWWWWWWWWWWWWWWWWWWWWWWW
WBBBBBBBBBBBBBBBBBBBBBBBBBBBBBBBBBBBBBBBBBBBBBBBBW
WBBBBBBBBBBBBBBBBBBBBBBBBBBBBBBBBBBBBBBBBBBBBBBBBW
WBBBBBBBBBBBBBBBBBBBBBBBBBBBBBBBBMBBBBBBBBBBBBBBBW
WWWWWWWWWWWBBBBBBBBBBBBBBBBBBBBBBBBBBBBBBBBBBBBBBW
WBBBBBBBBBBBBBBBBBBBBBBBBBBBBBBBBBBBBBBBBBBBBBBBBW
WWWWWWWWWPWWWWPWWWWPWWBBBBBBBBBBBBBBBBBBBBBBBBBBBW
WBBBBBBBBBBBBBBBBBBBBBBBBBBBBBBBBBBBBBBBBBBBBBBBBW
WBBBBBBBBBBBBBBBBBBBBBBBBBBBBBBBBBBBBBBBBBBBBBBBBW
WBBBBBBBBBBBBBBBBBBBBBBBBBBBBBBBBBBBBBBBBBBBBBBBBW
WWWBBBBBBBBBBBBBBBBBBBMBBBBBBBBBBBBWWWMWBBBBBBBBBW
WBWWBBBBBBBBBBBBBBBBBBBBBBBBBBBBBBBBBBBBBBBWWWWWWW
WBBWWBBBBBBBBBBBBBBBBBBBBBBBBBBBBBBBBBBBBBBBBBBBBW
WBBBWWBBBBBBBBBBBBBBBBBBBBBBBBBBBBBBBBBBBBBBBBBBBW
WBBBBWWBBBBBMBBBBBBBBBWWWWBBBBBBBBBBBBMBBBBBBBBBBW
WBBBBBWBBBBBBBBBBBBBBBWBBBBBBBBBBBBBBBBBBBBBBBBBBW
WBBBBBWBBBBBBBBBBBBBBBWBBBBBBBBBBBBBBBBBBBBBBBBBBW
WBBBBBBBBBBBBBBBBBBBBBWBBBBBBBBBBBBBBBBBBBBBBBBBBW
WBBBBBBBBBBBBBBBBBBBWWWBBBBBBBBBBBBBBBBBBBBBBBBBBW
WBBBBBBBBBBBBBBBBBBBBBBMBBBBBBBBBBBBBBBBBPBBBBBBBW
WBBBBBBBBBBBBBBBBBBBBBBBBBBBBBBBBBBBBBBBBBBBBBBBBW
WBBBBBBBBBMBBBBBBBBBBBBBBBBBBBBBBBBBBBBBBBBBBBBBBW
WBBBBBBBBBBBBBBBBBBWPWBBBBBBBBBBBBBBBBBBBBBBBBBBBW
WBBBBBBBBBBBBBBBBBBBBBWWWWWWWWBBBMBBBBBBBBBBBBBBBW
WBBBBBBBBBBBBBBBBBBBBBWBBBBBBBBBBBBBBBBBBBBBBBBBBW
WBBBBBWWWWBBBBBBBBBBBBWMBMBBBWBBBBBBBBBBBBBBBBBBBW
WBBBBBBWBBBBBBBBBBBBBBWWWWWWWWBBBBBBBBBBBBBBBBBBBW
WBBBBBBWBBBBBBBBBBBBBBBBBBBBBBBBBBBBBBBBBBBBBBBBBW
WBBBBBBWBBBBBBBBBBBBBBBBBBBBBBBBBBBBBBBBBBBBBBBBBW
WWWWWWWWWWWWWWWWWWWWWWWWWWWWWWWWWWWWWWWWWWWWWWWWWW